1111111111111111111111111111111111
1100000000000000000000000000000001
11P00000000000000000000000C0000001
1100000000000000000000000000000001
11000C0000000000000000000000000001
1100000000000000000000000000000001
1100000000000000000000000000000001
1100000000000000000000000000000001
110000000C000000000000000000000001
1100000000000000000000000000000001
1100000000000000000000000000000001
1100000000000000000000000000000001
1100000000000000000C00000000000001
1100000000000000000000000000000001
1100000000000000000000000000000001
11000000000000000000000000000C0001
1100000000000000000000000000000001
1100000C00000000000000000000000E01
1100000000000000000000000000000001
1111111111111111111111111111111111