1111111
100C0P1
1E00001
1111111