111111111111111111111111111111111111
111111111111111111111111111111111111
111000000000000000000000000000000011
111000000000000000000000000C00000011
111000000000000000000000000000000011
111000C00000000000000000000000000011
111000000000000000000000000000000011
111000000000000000000P00000000000011
111000000000000000000000000000000011
1110000000C0000000000000000000000011
111000000000000000000000000000000011
111000000000000000000000000000000011
111000000000000000000000000000000011
11100000000000000000C000000000000011
111000000000000000000000000000000011
111000000000000000000000000000000011
111000000000000000000000000000C00011
111000000000000000000000000000000011
11100000C00000000000000000000000E011
111000000000000000000000000000000011
111111111111111111111111111111111111
111111111111111111111111111111111111