111111111111111111111111
111111111111111111111111
111111111111111111111111
111111111111111111111111
111111111111111111111111
111000111111111100000111
111000100000000001000111
111P00100000C00001000111
111000100000000001000111
111000100000000001000111
11100000111111111100E111
111111111111111111111111
111111111111111111111111
111111111111111111111111
111111111111111111111111
