1111111111111111111111111
1111111111111111111111111
1111110001111011111111111
1100011000000000111111111
110P011111000000000011111
1100011111001110111000111
1100110000010110111010111
110011011101C110111000111
1100110111010110111000111
11000000000000000000E0111
1100111001101110011000111
1100111000001010011010111
1111111111111000001010111
1111111111111111111111111
1111111111111111111111111