111111111111111111111111
111111111111111111111111
111111111111111111111111
111111111111111111111111
111000111111111100000111
111000100000000001000111
1110P0100000C00001000111
1110001000000000010E0111
111000100000000001000111
111000001111111111000111
111000111111111111111111
111111111111111111111111
111111111111111111111111
111111111111111111111111
