1111111111111111111111111111111111111111
1000000000P00000000000000000000000000001
1011111111111111111110111111111111111101
1000100000000000000000100000000000000101
1010101011111111111110101111111111110101
1010001010000000000000101000000000000101
1011111010111111111110101011111111110101
1000000010100000000000101010000000000101
1111111010101111111110101010111111110101
1000000010101000000000101010100000000101
1011111010101011111110101010101111111101
1000100010001010C00000100010100000000001
1010101011111010111111101010111111111111
1010001000000010100000001010000000000001
1011111111111010111111111010111111111111
10000000000000100000000010100E0000000001
1111111111111111111111111111111111111111