111111111111111111111111
111111111111111111111111
111000111111000000000111
1110001000000000C0000011
1110P01000000100000E0111
111000000111000000000011
111111111110000011111111
111111111111111111111111
111111111111111111111111