111111111111111111111111
111111111111111111111111
111000111111000010000111
111000100000000010000011
111000100P000C0000100011
11100010000001000000E011
111000100111000010000111
111111111111111111111111
111111111111111111111111