111111111111111111111111111111111111111111111111111111111111
111111111111111111111111111111111111111111111111111111111111
111111111111111111001111111111111111111111111111111111111111
111000000000000000001000000000000000000000000000000000000111
1110000P0000000000001000000000000000000000000000000000000111
111000000000000000001000000000000000000000000010000000000111
111000000000000000001000000000000C00000000000010000000000111
111000000000010000001000000000000000000000000010000000000111
1110000100000100000000000000000000000000000000100000E0000111
111000010011110000000000000000000000000000000010000000000111
111111110011111111111111111111111111111111111110011111111111
111111111111111111111111111111111111111111111111111111111111
111111111111111111111111111111111111111111111111111111111111