111111111111111111111111
111111111111111111111111
111111111111111111111111
111111111111111111111111
100000000000000000000001
100000000000000C00000001
100000000000000000000001
100P00000000C00000000001
100000000000000000000001
100000000000000000000001
100000000000000000000001
10000C000000000000000E01
100000000000000000000001
100000000000000000000001
111111111111111111111111
