1111111111111111111111111111111111
1000000000000000000000000000000001
10P000000000000C0000000000C0000001
1000000000000000000000000000000001
10000C0000000000000000000000000001
1000000000000000000000000000000001
10000000000000000000000000C0000001
1000000000000000000000000000000001
100000000C000000000000000000000001
1000000000000000000000000000000001
1000000000000000000000000000000001
1000000000000000000000000000000001
10000000C0000000000C00000000000001
1000000000000000000000000000000001
1000000000000000000000000000000001
10000000000000010000000000000C0001
100000000000001C000000000000000101
1000000C00000001000000000000000E11
1000000000000000000000000000000101
1111111111111111111111111111111111
