1111111111111111111111111111111111
1E0000000000000C0000000C0000000001
1000010100100000101001000000010101
11100100101010100C1001000000010101
1P0000000C00C0000000000000000000C1
1111111111111111111111111111111111
