1111111211
1222222222
1333333333
1444444444
1555555555
1666666666
1777777777
1888888888
1999999999
1000000000
